1111111111111111111111
1E00M0CM00MMM00C000001
10C00C0C00CM0000C0C001
10C0M000C0C0C0C000CM01
1P0000MM0C00C0000000C1
1111111111111111111111