1111111111111111111111
1E00M0CM00MMM00C000001
10100101001M0000101001
1010M10010101010001M01
1P0000MM0C00C0000000C1
1111111111111111111111