1111111111111111111111
1E0000C00000000C000001
10100101001M0000101001
1010010010101010001M01
1P00000M0C00C0000000C1
1111111111111111111111